1111111111
1000001C01
10C11C0101
1011E10101
100000P001
1111111111
